Level 4 (merci à E. Porte)
23
##########
#H#K B####
# BSO L ##
#B B BB D#
# B B BB #
## B B ###
##########